R 1920       1080
NO ./includes/4.xpm
SO ./includes/2.xpm
WE ./includes/3.xpm
EA ./includes/1.xpm
S ./includes/sprite.xpm
F 50,100,150
C 255,30,0


1111111111111111111111
1000000000000000000001
1000000000000000000001
1000000000000000000001
1000000000000000000001
1000000000000000000001
1000000000000000000001
1000000000000000000001
1000000000000000000001
1000000000000000000001
10000000000N0000000001
1000000000000000000001
1000000000000000100001
1111111111111111111111