R 1920       1080
NO ./includes/4.xpm
SO ./includes/2.xpm
WE ./includes/3.xpm
EA ./includes/1.xpm
S ./includes/sprite.xpm
F 50,100,150
C 255,30,0


1111111
1S00101
1220001
1200011
111111
